15 0.103514 0.686347 0.058824 0.086101
15 0.102368 0.432349 0.064171 0.089791
15 0.758594 0.442189 0.050420 0.082411
15 0.807487 0.356704 0.048892 0.081181
15 0.814744 0.196802 0.057296 0.091021
15 0.537051 0.217712 0.055004 0.091021
15 0.310160 0.223247 0.047364 0.087331
16 0.601604 0.385609 0.176471 0.409594
16 0.490069 0.765683 0.401070 0.348093
16 0.076776 0.793358 0.152024 0.273063
16 0.078686 0.319803 0.155844 0.307503
16 0.394194 0.372694 0.232238 0.425584
16 0.789916 0.587946 0.192513 0.373924
16 0.787242 0.281673 0.190222 0.243542
15 0.734912 0.073801 0.058060 0.078721
15 0.606188 0.109471 0.054240 0.073801
15 0.855233 0.074416 0.060351 0.082411
