15 0.374332 0.894219 0.055004 0.093481
15 0.610008 0.769373 0.060351 0.082411
15 0.323147 0.077491 0.059587 0.093481
15 0.390374 0.179582 0.065699 0.098401
15 0.468296 0.071341 0.064171 0.105781
15 0.679908 0.078721 0.061115 0.093481
16 0.492361 0.304428 0.277311 0.340713
16 0.488541 0.904674 0.277311 0.183272
16 0.843392 0.615621 0.313216 0.261993
